%=percent,pct.
13 Week High=high/low/volume,market data column
13 Week Low=high/low/volume,market data column
26 Week High=high/low/volume,market data column
26 Week Low=high/low/volume,market data column
52 Week High=high/low/volume,market data column
52 Week Low=high/low/volume,market data column
About Trader Workstation=version
Accept=confirm
Account=account window,balances,margin requirements,market value,portfolio margin,export,portfolio,positions,Reg T,RegT,Regulation T,Liquidation,Liquidity,Funds
Account Management=flex,activity statements,permissions,subscriptions,market data,admistration,funds management,trading access,report management,deposits,transfers,withdrawls
Account Window=balances,margin requirements,market value,portfolio margin,export,portfolio,positions,Reg T,RegT,Regulation T,Liquidation,Liquidity,Funds
Accumulation/Distribution Line=technical indicator,non-overlayed,study,accumulation,distribution
Action=Buy,Sell,order management line,parameters
Action on order when alert triggers=message,e-mail,email,sms,flash rows,pop up,popup,audio,custom,submit order,cancel order
Action on order when condition triggers=message,e-mail,email,sms,flash rows,pop up,popup,audio,custom,submit order,cancel order
Activate=deactivate
Add Auto Stop Order=attach
Add Condition=Action,Alert
Add Contract=chart
Add Fibonacci Line=technical indicator,technical analysis,draw,drawing,retracement,study
Add Free Hand Trendline=support,resistance,chart,draw,technical,analysis,drawing
Add Horizontal Trendline=support,resistance,chart,draw,technical,analysis,drawing
Add Line=insert row
Add More Buttons=user-configurable buttons,user configurable buttons
Add New Chart to Existing Chart Window=subchart,real-time,technical analysis
Add New Chart=sub-chart,subchart
Add Selected Contract to Existing Chart=sub-chart,subchart
Add Study=technical indicator
Add Symbol=ticker,underlying
Add Ticker=symbol,underlying,security
Add To Rebalance Window=portfolio,weight,positions,order entry tools
Add Trailing Stop Order=aux price,trailing amount
Add Underlying=ticker,symbol
Add Vertical Space to Chart=axis,extra
Add Vertical Trendline=support,resistance,chart,draw,technical analysis,drawing
Adj Order Type=adjustable stop,order columns, change,modify,replace,adjust,open order,pending order,active order,parameters
Adj Stop Lmt Price=adjustable stop,order columns,change,Limit,modify,order parameters,replace
Adj Stop Price=adjustable stop,order columns,change,modify,active order,order parameters,replace,STP
Adj Trailing Amnt=adjustable stop,order columns,change,modify,adjust,amount,order parameters,replace
Adjust Position or Average Price=account window,portfolio,forex,foreign exchange,what-if,hypothetical,what if
Adjust to Order Type=replace,modify,pending order,open order,active order,parameters
Adjustable Stop=order columns,modify,replace,stop price,parameters,pending order,open order,active order,STP
Adjusted Stop Limit Price=order column,adjustable stop,change,Adj,modify,order parameters,replace,LMT
Adjusted Stop Price=adjustable stop,order column,change,Adj,modify,order parameters,replace,STP
Adjusted Trailing Amount=order columns,adjustable stop,Amnt,change,modify,Adj,amount,order parameters,replace
ADX/DMI=study,technical indicator,directional,movement,non-overlayed,ADX,DMI
Alarms=Alert,Real-time activity monitoring,set alarm,alarm settings,warning sound
Alert=alarms,Pop up,pop-up,conditions,actions,Real-time activity monitoring,e-mail,sms,email,messages,audio,flash rows,repeatable
Alerts=alarms,Pop up,pop-up,conditions,actions,Real-time activity monitoring,e-mail,sms,email,messages,audio,flash rows,repeatable
Algorithm Orders=VWAP,arrival price,percentage of volume strategy,algo,order type
All or None=order,type,protection,AON,All-or-none,attribute
All-or-none=All or None,order,type,protection,AON,All-or-none
Allow condition to be satisfied and activate order outside of regular trading hours.=Alerts
Allow stop triggering outside of regular trading hours=STP,Stop,RTH,order defaults
Allow this order to be filled outside of regular trading hours=RTH,Order defaults
Allowed Order Quantity=Quan,size
Analyst Information=Fundamental,Analysis
Analytics=Interactive analytics,option analytics,portfolio analytics
Annual=yearly
API=Application Program Interface,DDE clients,ActiveX,socket port
Arbitrage Combo=Merger,arb
Arbitrage Meter=Arb,index,futures,Market Data Tools
Armed=Book Trader,BookTrader,enabled,active
Ascending=sort,increasing,rising
Ask=Ask price,market data column,NBO,offer,ask exchange,ask size
Ask Exch=Exchnage,market data column
Ask Exchange column=Ask Exch.
Ask Size=market data columns
Ask Yield=implied yield,bonds,market data columns
Attach Bracket Orders=bracketed buy order,bracketed sell order,OCA group
Attach Page=reconnect page,restore page,reattach page
Auc. Price=auction price,price improvement,options
Auc. Volume=auction volume,options
Auction=auc.,price improvement,options
Auction Columns=auc.,price improvement,options
Auto=automatic
Auto Combo Limit=automatic combo,auto combo lmt,auto-combo lmt,auto-combo limit
Auto Combo Market=automatic combo,auto combo mkt,auto-combo mkt,auto combo market
Auto Export=automatic export,auto-export,export,global configuration
Auto Future Rollover=automatic future rollover,Global Configuration,auto-future rollover
Auto Stop=automatic stop,auto-stop,auto stp,auto-stp
Auto Trailing Stop=auto-trailing stop,auto-traling stp,auto trailing stp
Auto-Adjust Stop-Lmt Price=auto-adjust stop-limit price,auto-adjust stp-limit price,auto-adjust stop limit price,auto-adjust stp lmt price,auto-adjust stp-lmt price
Autofit=auto-fit,chart parameters,combined contracts
Auto-future rollover=auto future rollover
Auto-limit=automatic limit,auto limit,auto-lmt,auto lmt,update,limit price,lmt price
Auto-Remove Orders=auto remove orders
Auto-Save Default Size=auto save default size
Auto-Sort Submitted Orders=autosort submitted orders
Auto-stop=Auto-STP,auto stop,auto stp
Auto-trailing stop=auto-trail,auto trailing stop,auto trailing STP
Aux Price=auxiliary,election,offset,relative,trailing,stop limit,order column,STP LMT
Average=av.,avg.
Average price column=av. Price column. Avg. price column
Average True Range=ATR,technical,indicator,volatility,non-overlayed
Average Volume=av. vol.,average vol.,avg. vol. av. Volume,avg. volume
Avg Price=Average price,av . Price
Avg. Price Precision=average price precision,av. Price precision,average precision
Basket=list,Order Entry Tools,BasketTrader,basket trader
Basket File=list,basket trader,baskettrader
BasketLayout=basket layout,basket columns
BasketTrader=list,Order Entry Tools,Basket Trader,index basket
Bid=bid price,market data column,NBB,bid size,bid exchange
Bid Exch=bid exchange,market data column
Bid Exchange column=bid exch. column,market data columns
Bid or Ask=bid/ask,bid-ask
Bid Size=market data columns
Bid Yield=implied yield,bonds,market data columns
Big Scale Prices=increment,order defaults,general
Big Scale Sizes=increment,order defaults,general
Blink always on new trade=flash always on new trade,trades icon
Blink if Trade window is closed=flash if Trade window is closed,trade icon
Block Order=Price improvement,order type,options
Bollinger Bands=study,technical indicator,overlayed,upper band,lower band,middle band
Bond Attributes=market data columns
Bond Columns=market data columns,yield,bond attributes
BookTrader=BT,Book Trader,DOM,Ladder,Order Entry Tools
BookTrader Colors=Book Trader colors,booktrader configuration
BookTrader Sound Manager=Book Trader sound manager,audio,beep,custom
Box Auction orders=Boston options exchange,order type,Auc price,auc volume
Bracket Orders=bracketed buy order,bracketed sell order,OCA group
Browse=search,find
Bulletin=Messages,notification
Buttons=Button Panel,user-configurable,user configurable,customize
Buy=order,action,transmit,parameter,go long
Buy or Sell Specific Product=hotkeys,actions,create orders
Call=option,buy,strike price,contract
Call/Put Interest=market data columns,options,call-put,int.
Call/Put Volume=market data columns,options,call-put,vol.
Cancel=delete,remove,negate
Cancel All=delete,remove,negate
Cancel All Orders=delete,remove,negate
Cancel and Reverse=delete,remove,negate
Cancel Contract's Orders=delete,remove,negate
Cancel order=delete,remove,negate
Cancel Page=delete,remove,negate
Cancel Page Orders=delete,remove,negate
Cancelled=delete,remove,negate
Chaikin Money Flow=technical indicator,CMF,study
Change=modify,replace,convert,market data column
Change (%)=change percent,change%,market data column
Change Order to Market=convert order to market,change order to mkt
Change Since Open=market data column
Chart=TWS charts,Graph,Technical analysis,real-time,chart image,chart template,chart parameters,chart study,chart bar,chart candle
Chart Colors=configure chart colors
Chart Parameters=time parameters
Charts=TWS charts,Graph,Technical analysis,real-time,chart image,chart template,chart parameters,chart study,chart bar,chart candle
ChartTrader=Technical analysis,order entry tools,chart trader
Chat=Traders' chat,help
Check Margin=margin requirements,trading limits,real-time margin monitoring
Cleanup orders=clear orders,remove orders,delete orders
Clear=remove,cleanup
Clear Alerts=reset alerts,remove alerts,delete alerts
Clear Chains=reset chains,delete chains,reset option chains,delete option chains,clear option chains
Clear Log=delete log,cleanup log,reset log,erase log
Clear Row=erase row
Clear Zero Position Rows=remove zero position rows,delete zero position rows,erase zero positions rows
Clearing=order entry column,allocation, clearing account,IBExecution Services,PTA clearing,away clearing
Clearing Acct=clearing account,IBExecution Services,PTA clearing,away clearing
Close=exit,ok
Close Alert=exit alert
Close All=exit all
Close All Non-base Currency Positions=exit All Non-base Currency Positions,flatten All Non-base Currency Positions
Close All Positions=exit all positions,flatten all positions
Close Currency Position=exit Currency Position,flatten Currency Position
Close Portion of Positions=exit portion of Positions,flatten portion of Positions
Close Position=exit position,flatten position
Close Positions on Page=exit positions on page,flatten positions on page
CMF=study,technical indicator,chaikin money flow,non-overlayed
Collapse=close
Color Text=configure text colors,configure appearance
Color Palette=look,feel,look & feel
Colors=configure colors,configure appearance
Columns=market data columns,order columns,portfolio columns,market value columns, layout
Combined Contracts=chart parameters,autofit,ratio,offset
Combo=combination ordrer,spread,leg,ratio,ISE,ONE,DTB,option analytics,combo selection,generic,strategy,calendar spread
Combos / Spreads=combination order,spread,leg,ratio,ISE,ONE,DTB,option analytics
Commodity Channel Index=CCI,study,technical analysis,non-overlayed
Compact=order ticket,comprehensive
Company Name=market data column
Company Profile=Fundamental Analysis,company info,company summary
Comprehensive=order ticket,compact
Conditional Orders=current conditions,add conditions,trigger method,trigger information,attributes
Conditions=alerts,alert conditions,price conditions,time conditions,cushion,volume conditions,trade conditions,indicator conditions
Configuration=Set-up,set up,defaults,settings,global configuration,columns,layout,parameters
Configure=Set-up,set up,order defaults,settings,global configuration,columns,layout,parameters
Configure Order Defaults=set up order defaults,set-up order defaults,configure order parameters
connected=link,market data connection
Continuous Update=streaming update,live update,continuous market data,live quotes
Continuously update limit price=volatility trading,option order,vol order type,LMT price
Contract=option,future
Contract search=search by contract
Convert Limit orders to=modify limit orders,LMT orders,replace limit orders
Copy=ctrl c
Copy tickers from page=ctrl c
Cost Basis=purchase price,sale price,Basis point,position price
Create Audit Trail=audit report,view audit trail,condensed,expanded
Create Header Row=text row,title row,label row
Create Market Scanner=Market Screener,Market scan,Technical Analysis
Create Orders=hotkeys,possible actions
Create Parallel with Selected Trendline=support,resistance,chart,draw,technical,analysis,drawing
Create Portfolio Page=positions,portfolio page,account window,holdings
Create Ticker=insert ticker,request ticker,underlying
Create Volatility Page=option volatility,trading window,volatility layout
Cross Orders=opening cross order,closing order cross,NASDAQ
CS Chat=Help,quick start,users' guide,tutorial,customer service,about,traders' chat,system status,release notes,web ticket
Currencies=FX,foreign currencies,foreign exchange
Currency=money,dollars
Customer Service=Help,CS,quick start,users' guide,tutorial,customer service,about,traders' chat,system status,release notes,web ticket
Customer Service Chat=Help,CS,quick start,users' guide,tutorial,customer service,about,traders' chat,system status,release notes,web ticket
Customer Service Info=Help,CS,quick start,users' guide,tutorial,customer service,about,traders' chat,system status,release notes,web ticket
Cut=ctrl v,cut & paste
Cut tickers from page=symbol,underlying,ctrl v
Daily=Daily P&L,DAY order,daily volatility
Daily Volatility=volatility trading,vol order type
Date=yyyymmdd,dividend date,expiration date,month,date,year
Deactivate=make inactive,disable
Deactivate on Close=make inactive on close,disable on close
Deactivate order=make order inactive,disable order
Deactivate Page=make page inactive,disable page
Deactivate Page Orders=make page orders inactive,disable page orders
Decrease price or size=modify,replace,adjust,hotkey,hot key,button
Default=order defaults,restore defaults
Default Accounts=account window,FA account
Default Give-ups=giveups,pre-trade give up,third-party clearing,CMTA,DTCID,Clearing,IBexecution
Default size=default quantity,default quan,order defaults,default order settings
Delay to Cleanup Canceled=modify order parameters,order configuration settings,trading window,seconds
Delay to Cleanup Filled=modify order parameters,order configuration settings,trading window,seconds
Delete=remove,cleanup,erase,cancel
Delete Dividend=remove dividend,clear dividend
Delete Line=remove line
Delete Row=remove row
Delete Rows/Cancel Orders=remove rows/cancel orders
Delta=greeks,option,risk,option trader,optiontrader,hedge,hedging
Delta column=greeks,option,risk,option trader,optiontrader,hedge,hedging
Description=contract description,company description
Destination=order management line,parameters,smart,destination exchange
Destination Exchange=destination exch.
Detach All Pages=separate all pages
Detach Page=separate pages
Disable All=make all inactive,disarmed
Discretionary amount=amt,attribute,display,price
Discretionary Amt=Amount,attribute,display,price
Disp. Size=reserve,iceberg,display,attribute,size,reserve,quan,quantity
Display=size,attribute,iceberg
Display Last Login Time=show last login time
Display server time=display settings,global configuration
Display Size=size,order type,discretion,reserves,iceberg,order management row
Display Size (Iceberg)=size,order type,discretion,reserves
Documentation=help,show help,quick start guide,tutorials,release notes, online users' guide
Don't show Unused Features dialog again=feature selector
Download Open Orders on Connection=pending orders,API,global configuration
Duplicate=buttons
Earnings Estimate=Fundamental,Analysis
Edit=change,modify,adjust
Edit Dividends=dividend column,market data column,dividend schedule,ex-dividend,option model
Enable ActiveX and Socket Clients=global configuration,API
Enable DDE Clients=global configuration,API
Enable Tooltips=global configuration,tooltips,disable tooltips
End Time=VWAP,algo orders,volume weighted average price
Envelope=study,overlayed,technical indicator,exponential moving avarage,ema,simple moving average,sma
Envelope=study,overlayed,technical indicator,exponential moving avarage,ema,simple moving average,sma
Estimated value of orders:=Baskettrader,basket trader,basket orders,basket file
Exchange=stock exchange,futures exchange,options exchange,stock market,destination,exch.,market data column
Exit=close
Exp. Date=expiration date,month,day,year,yyymmdd
Exp. date (yyyymm)=expiration date,month,day,year
Exp. Date (yyyymmdd)=expiration date,month,day,year
Exp. Time=expiration time,hour,minute,second
Exp. Time (hh:mm:ss)=expiration time,hour,minute,second
Expand=collapse,panel
Expiration Date=Exp. Date,month,day,year,yyyy,dd,dd
Expiration Time=exp. time,hour,minute,second
Expiry=expiry date,exp.,option expiration
Exponential Moving Average=avg.,study,EMA,technical indicator,overlayed
Exponential Moving Avg.=study,EMA,technical indicator,overlayed
Export Page in Excel Format=excel,trades window,executions window
Export Portfolio=excel,trades window,executions window
Export Previous Day's Reports=excel,trades window,executions window
Export Summary=excel,trades window,executions window
Export Today's Reports=excel,trades window,executions window
Farm Name=market data connections
Feature Selector=enable,disable,TWS feature selector
Features=selector,enable,disable
Features Poll=Suggestions,Feature Forum
File=basket file,filename,import contracts,chart definition file,image file,settings file
Fill Amt.=Amount,partial
Fill-or-Kill=FOK,TIF,time in force,attribute,fill or kill
Financials=Fundamental,Analysis
Firm/Electronic quotes only=global configuration,order defaults,exclude exchanges,smartrouting,smart
First Key=trailing key
Flash Bulletin=Messages,notification
Font Size=global configuration,display,font size,font style
Font=global configuration,display,font style
Fundamentals=reuters
Future Rollover=auto future rollover,expiration,future symbol
Future Wizard=future rollover
FX Price Display=Foreign Exchange,Fxtrader,currency pairs,order entry tools,cell
FX Trader=currency,Pairs,Foreign,Exchange,Cell,Order Entry Tools,Fxtrader
Gamma column=greeks,option,delta,risk,optiontrader,option trader,hedge,hedging
Gap=market data coulmn,prices
General=Global Configuration,config,configure,language
Global Configuration=Config,configure,settings,order defaults
Good After time=TIF,Time in force,duration
Good-after=TIF,Time in force,duration
Good-until=TIF,Time in force,duration
Graph name=Chart
Greeks=option,risk,option trader,optiontrader,hedge,hedging
Group Name=oca group
Group trades by price=trades window settings,executions window
Hedge Aux. Price=volatility trading,vol order type,delta neutral,hedge delta aux. price,order column
Hedge Order Type=volatility trading,vol order type,delta neutral
Help=CS,quick start,users' guide,tutorial,customer service,about,traders' chat,system status,release notes,web ticket
Hidden=order type,attribute,size,discretion
Hide=hide pennies,hide arbitrage meter,hide features,collapse
Hide Pennies=order attribute,order column,option pricing,show penny options,num. options,penny option contracts
Hide Trader Dashboard=Account data,Ticker,Real-time activity monitoring
High=OHLC,market data column
Histogram=booktrader,book trader,column,price
Historical Charts=bigcharts,web chart,historical data,historical price
Historical Vol.=historical volume
HMDS=market data,connections,server
Hotkey Details=hot key
Hotkeys=hot keys,customize,shortcuts,instantaneously
How to show=chart parameters,bar increment,time increment
Imbalance=rebalance window
Immediate-or-Cancel=IOC,order type
Imp. Vol. (%)=implied,volatility,percent
Import Contracts=file name,symbols,tickers,excel
Include FX positions in portfolio=foreign,exchange
Include FX positions when sending portfolio=foreign,exchange
Increase price or size=modify,change,oprn order,pending order,qunatity,active order
Index Arbitrage Meter=Arb,index,futures,Market Data Tools
Index Panel=basket,basket trader,weight,market cap,beta,weighted components,true composition
Initial Component Size=order management columns,trading window,quantity,scale order
Insert=row,create
Insert Blank Row=insert row
Insert Dividend=option modeler,interactive analytics
Insert Row=insert blank row
Insider Trading=Fundamental Analysis
Instrument=security,ticker,underlying
Int. Rate=Interest Rate, currencies,EFP interest rate
Interactive Brokers Home Page=web page,webpage,homepage
Interactive Brokers Trader Workstation=TWS,help,about
Interactive News=RSS,Fundamental Analysis,headlines,news window,news ticker,reuters
Interest Rate=Int. Rate, currencies,EFP interest rate
ISE Order Type=International Securities Exchange,SOI,anonymous
Jump to Rapid Order Entry=ROE,order entry tools
Keep Application on Top=pin
Keep chart up-to-date=real-time,realtime
Large Shareholder=stockholder,majority share holder
Last=last price,marker data column
Last Size=market data column,size
Last Yield=bond,market data columns
Layout=customize,columns,colors,default,configure
Limit Price=LMT,Limit order
Limit-if-Touched=LIT,limit,touched,order type
Limit-on-Close=LOC,close,limit,order type
LMT=Limit,Limit Order,Limit price,Limit offset,order type,basic,price improvement
Lmt Price=Limit,Limit Order,update limit price
Lmt. Offset=Limit,Limit Order,limit offset
Lmt. Price=Limit,Limit Order,order type,protection
Load=basket file,open
Load Basket=basket file,list,basket trader,baskettrader,order entry tools
Load Chains=Optiontrader,option trader,Order Entry Tools,extended option quotes
Loading=working,chart
Location=destination
Lock Application=security,shutdown,password
Lookup=lookup symbol,find underlying,lookup primary,look-up
Lookup Symbol=find underlying,find primary,look-up,lookup primary symbol
Low=OHLC,market data column
MACD=study,technical indicator,oscillator,EMA,non-overlayed,moving,average,convergence,divergence
Manage Workspaces=workspace,import workspace,export workspace,new,workspace,load workspace,duplicate workspace,rename workspace,delete workspace,apply workspace
Manual=Help,Quick start guide,online users' guide
Market=MKT,order,order type,basic,speed of execution
Market Data=quotes,streaming,connections
Market Data Connections=streaming quotes
Market Depth=MD,market data tools,MKT depth,level 2,open book,totalview,total view,level two
Market Depth (Open Book, TotalView)=market data tools,MKT depth,level 2,open book,totalview,total view,level two
Market Scanner=scanner,Screener,scan,Technical Analysis,monitor,market view,parameter,filter,location,instrument,market watch
Market To Limit / Box Top=attribute,option order type,MTL
Market Value=market data column,P & L,position
Market Value column=market data column,P & L,position
Market With Protection=market-with-protection,order type,futures,future options
Market-if-Touched=market if touched,MIT,order type
Market-on-Close=closing price,stocks,order type,MOC
Merger Arb=Arbitrage,merger arbitrage window,MA window,risk arbitrage
Merger Arbitrage=Arb,merger arb window,MA window,risk arbitrage
Messages=alerts,bulletin
MFI=study,technical indicator,money flow indicator,momentum,non-overlayed
Min. Quantity=Minimum,Quan
Minimize all windows=min.,minimize all
Minimum Quantity=min. quan
Misc=miscellaneous
MisTrade Request=mis-trade,order cancellation request,tickets,account management,web ticket,webticket
Mkt Depth=Market Depth,Market Data tools,open book,total view,totalview,level 2,level two
Mkt Scanner=Screener,scan,Technical Analysis
Model=option modeler,interactive analytics,volatility function,dividend schedule,interest rate
Modify=change,replace,edit
Modify or Remove=change,replace,cancel
Modify Order Type=change,adjust,replace, pending order,change,open order,active order
Modify Time-in-Force=change,adjust,replace, pending order,change,open order,active order,TIF,time in force,attribute
Momentum=technical,indicator,non-overlayed
Money Flow Index=study,technical indicator,MFI,non-overlayed
More Icons=toolbar,configure,buttons
Move Selected Trendline=support,resistance,chart,draw,technical,analysis,drawing
Moving Avg. Conv. Div.=study,technical indicator,MACD,oscillator,EMA,non-overlayed,moving,average,convergence,divergence
Multiplier=basket,basket file,multiply,quantity
Never blink=trades icon,flash
New=open,load,add
New Chart Window=add chart window,real-time chart,load chart template,open chart image
New Chart=add chart window,real-time chart,load chart template,open chart image
New Features=features selector
New Real-time Chart for Selected Contract=add chart window
New Real-time Chart=add chart window,open chart
New Tab=trading window,pages,option trader,option tab,new page,add page
New=open,load,add
News=RSS,Fundamental Analysis,headlines,news window,news ticker,reuters
News and Research=RSS,Fundamental Analysis,reuters
News Configuration=RSS links,RSS suppliers,global configuration,news supplier,reuters
News Proxy=RSS,proxy host,proxy port
News Suppliers=RSS,RSS links
Next=forward
Next Contract=forward
Non-Guaranteed=combo,miscellaneous tab,order ticket,spreads,combination orders,non-guaranteed execution
NYSE Open Book=Market Depth,Market Data tools,open book,total view,totalview,level 2,level two
OBV=study,on balance volume,technical indicator,non-overlayed,momentum
OCA Group=OCA order,one,cancels,all,conditional,order group,one-cancels-all,order column
OCA Orders=one,cancels,all,group,conditional
OCA Type=one,cancels,all,group,conditional
Offset=order defaults,customize,bracket,configure hotkey,offset amount,order types,user-defined,scale,relative
Offset amount=offset amnt. order defaults,customize,bracket,configure hotkey,order types,user-defined
OK=apply,okay
OMS Basket Stage=order management system,Order Entry Tools
OMS BasketTrader=order management system,Order Entry Tools
OMS Trader=order management system,Order Entry Tools
On Balance Volume=OBV,study,technical indicator,momentum,non-overlayed
Online Users' Guide=Help,Quick start guide,tutorials
Open=new,load
Open / Close=open/close,open-close,open close,open / close
Open Chart Image=load chart image
Open Chart Template=load chart template
Open Interest=OI,option open interest,future open interest,option chain column,option statistics
Open Saved Chart=load saved chart
Open Web Ticket=mistrade ticket, mis-trade ticket
Opn/Cls=open/close,open-close,open close,open / close
Opt. Implied Vol.=option implied volume,option analytics,option chain,Option Trader,OptionTrader
Opt. Volume=option implied volume,option analytics,option chain,Option Trader,OptionTrader
Opt. Volume Change=option implied volume,option analytics,option chain,Option Trader,OptionTrader
Option Analytics=Interactive analytics,Risk Management Tools,delta-call,delta,delta-put,gamma,vega,theta,option trader,optiontrader
Option Chains=Option Trader,OptionTrader,load chains,extended option quotes
Option Exercise=option exercise window,option expiry
Option Model column=volatility function,dividend schedule,interest rate
Option Modeler=Risk Management Tools,volatility curve,dividend schedule,interest rates,volatility profile,volatility function
Option relative-to-stock orders=aux. price,order type,price improvement,user-defined,offset
Option Spreads=combo selection,option strategy,legs,generic
Option Type=call,put
Option Wizard=order types,order preview,order entry tools,order wizard
Options Exercise=option expiry,option exercise window
OptionTrader=OT,Option,chain,Order Entry Tools,Option Trader,greeks
Order=order ticket,order type,order types,transmit,cancel,order entry tools,order defaults,order management row
Order Columns=trading window,layout,order management row
Preset=order preset,order presets
Order Ref=Reference number
Order Ticket=entry,preview,compact,comprehensive
Order Type=Order Wizard,order management line,parameters,LMT,limit,MKT,market,STP,stop,order defaults,complex order types
Orders=order ticket,order type,transmit,cancel,order entry tools,order defaults,order management row
Origin=default order origin,order origin,location,exchange
Other Layouts=default layout,trading window,global configuration,market data columns,order management columns
Outside Regular Trading Hours=RTH,after-hours,afterhours
Overfill Protection=OCA order
P & L=Profit,loss,P&L,PnL,Profit and loss,PandL,P and L,market data columns,account window columns
P&L column=Profit,loss,P&L,PnL,Profit and loss,PandL,P and L,market data columns,Real-time activity monitoring
P&L columns on account window=account window columns,P&L,PnL,P and L
Page=trading window,tabs,settings,default layout,portfolio page,pending page,volatility page
Parabolic SAR=study,technical indicator,overlayed,stop and reversal
Paste=cutnpaste,ctrl v
Paste tickers to page=symbols,underlying
Pct. Offset=percent,scale order,relative order,bracket order,customize hotkey
Peg-to-Market=peg to market,order type,stock,delta
Penny Options=order attribute,order column,option pricing,show penny options,num. options,penny option contracts
Percent=%,pct.
Percent Offset=pct.,scale order,relative order,bracket order,customize hotkey
Pivot Points=technical indicator,study,overlayed,resistance,support
Plugins=plug-ins
Portfolio=positions,portfolio page,account window,holdings
Portfolio Analytics=Interactive analytics,Risk Management Tools,underlying summary,dimension summary,portfolio risk,var summary,position risk
Portfolio Columns=account window
Position=portfolio page,account window,total shares,total contracts,long position,short position
Post Trade Allocations=post-trade,IBexecution
Prem. Currency=order ticket
Pre-open Re-route=preopen,reroute
Preserve Time Priority=order ticket,misc. tab,prohibit cancellation,prohibit resubmit
Preview=order preview,order wizard,order ticket
Previous=back
Price=order management line,parameter,attribute,last price,bid price,ask price
Price/Value Info=price-value info,price value info,price/value information,price/value pop up,price/value popup
Primary Exchange=primary exch,smart routing,smart routing
Prompt when Exiting=prompt when closing
Purpose=reason,aim
Put=option,sell option,contract
Put/Call Interest=put-call interest,market data columns,put call interest
Put/Call Volume=put/call vol,put-call vol,put call volume,put-call volume,put call vol,market data columns
Quantity=size,quan,parameters,order management line,shares,contracts
Quantity Type=quan,quantity by currency,quantity by delivery value,quantity by DLV amount,quantity as a % of net liquidation value,quantity as %NLV,quantity as % of position change
Quantity Value=currency type,quantity type
Query=question
Quick Start Guide=help,quickstart
Quick Stock Entry=Market Data tools
Quick Stock Entry Exchanges=Global Configuration,SMART,quick stock entry exch.
Quote Panel=market data,quote line,level 1 data,order entry tools
Rapid Buy=Rapid Order Entry
Rapid Order Entry=ROE. Quick,fast,speed,Order Entry Tools,rapid stock entry,rapid option entry,rapid combo entry,rapid order entry settings,trading window
Rapid Sell=Rapid Order Entry
Rate of Change=study,technical indicator,non-overlayed,momentum
Realized P & L=Profit,loss,realized P&L,realized Profit and loss,realized PandL,realized P and L,market data column
Real-time Charts=charts,graphs,technical analysis
Rebalance=Order Entry Tools,portfolio,rebal %,redistribute,positions
Rebalance Window=Order Entry Tools,portfolio,rebal %,redistribute,positions
Re-center=ladder,Book Trader,Booktrader,midpoint
Reduced in size=OCA groups,default
Reference Price Type=volatility,volatility type,vol orders,NBB,NBO
Refresh=Refresh chart
Regular Trading Hours only=RTH,after-hours trading,after hours trading
Relative=relation
Relative Strength Ind=study,technical,indicator,RSI,non-overlayed
Release Notes=help,TWS release notes,release topics
Relevant EFPs=Relevant EFPs tool,scan,exchange of future for physical,SSF,EFP window
Remove All Trendlines=erase,support,resistance,chart,draw,technical,analysis,drawing
Remove Filled Orders=cleanup orders,clear filled orders
Remove Selected Trendline=erase,support,resistance,chart,draw,technical,analysis,drawing
Remove Unwanted Bar=hide bar,erase bar,replace bar,delete bar,remove spike
Remove Vertical Space from Chart=remove space,delete space,chart space
Req Market Data=Request,quotes
Request For Quote (RFQ)=Market Data tools,market data,European options,RFQs
Request Trade Cancellation=Account management,customer service,cs website
Reset=adjust,clear,load defaults
Reset Compressed View=pending page,filter field,enter search string
Reset Contracts=load contracts
Restore=restore settings,reinstate
Restore Settings=load settings
Restore size after taking profit=adjust size,modify size,restore quantity, restore quan
Reuse Rejected Order=rejected order,rejected quantity
Reverse=invert,resubmit,cancel and reverse,reverse position
Reverse Position=cancel and reverse,invert,resubmit,replace
RFQ - Request for Quote=Market Data tools,market data,European options,RFQs
Round US stocks to 100 shares=adjust,size,quantity,quan
Routing=order routing system,order management,order execution,smartrouting,smart
RSI=technical,indicator,relative strength indicator,momentum,overbought,oversold
Save=remember,save settings,save chart template,save alert,save chart image,save workspace,save chart,save basket file
Save Basket=BasketTrader,Basket Trader,index basket,basket file
Save Basket As=BasketTrader,Basket Trader,index basket,basket file
Save Chart Image=chart picture,jpg,image file
Save Chart Template=save chart layout,save chart parameters,.tpl
Save Chart=chart definition file,.def
Save Executed Portion as Reverse Basket=basket trader,basket trader,basket file,reverse order,filled orders
Save Orders As Basket=basket file
Save Settings=remember settings
Scale Incr.=scale order,increment,component size,price increment
Scale Increment=scale order,increment,component size,price increment,scale incr.
Scale Init.=initial component size,scale order
Scale Order Levels=order types,discretion,price,algorithm,algo,display
Scale Orders=order types,discretion,price,algo,algorithm,display,component size,profit offset,scale increment
Scale Profit Offset=scale order
Scale Sub.=subsequent component size,scale order
ScannerLayout=Screener,scan,Technical Analysis,filter,parameter
Search=find,seek
SEC Filings=Fundamental Analysis
Security Type=bonds,stocks,futures,options,warrants
Select All=highlight
Sell=action,transmit
Sell short=go short,short position,cover,close
Set Alarm=audio,Real-time activity monitoring
Set Auto Log Off Time (HH:MM)=log-off,logoff
Set ignored daily time interval=chart parameters,time period
Set Liquidate Last=margin requirements,liquidation queue
Settings=components,pages,layout,config,configure,global configuration,parameters
Settings=components,pages,layout,config,configure,global configuration
Shareholder=stockholder,shockownership
Shift Time Period to Present=chart time period,chart date,interval
Shift Time Period=chart time period,chart date,interval
Shortable=shortable stocks list,shortable column,market data column
Show=display
Show Arbitrage Meter=display arbitrage meter,Arb,index,futures,Market Data Tools
Show Avg Price=show average price,display average price
Show Bars=display bars, bar data,chart bars
Show BasketTrader=Order Entry Tools,Basket Trader
Show Bid/Ask=show bid ask,display bid ask,show bid-ask,display bid-ask,display bid/ask
Show BookTrader=DOM,Ladder,Order Entry Tools
Show Candlesticks=bars
Show data in user time zone=chart parameters window,new chart window
Show data outside of regular trading hours=RTH,after-hours trading,after hours trading
Show Description=contract description,company description,fundamentals
Show Details=contract details,contract info
Show difference=autofit,combined charts,combined contracts,chart parameters
Show Earnings Estimate=Fundamental Analysis,book value,earnings growth rate
Show FX Trader=Foreign Exchange,Fxtrader,currency pairs,order entry tools,cell
Show Help=quick start,users' guide,tutorial,customer service,about,traders' chat,system status,release notes,web ticket
Show Hotkey Popup=pop up,pop-up,hot key
Show Index Panel=basket,basket trader,weight,market cap,beta,weighted components,true composition
Show Leg Trades Only=combo,combination,spread
Show Legs=leg trades,combo,combination,spread
Show Market Depth=MD,market data tools,MKT depth,level 2,open book,totalview,total view,level two
Show Market Scanner=Screener,scan,Technical Analysis
Show MidPoint=chart parameters
Show News for Selected Contract=RSS,headlines
Show News for Selected Contract in Browser=news window
Show OATS Reports=Order audit trail system
Show Option Analytics=Interactive analytics,greeks,volatility curve
Show OptionTrader=Option,chain,Order Entry Tools,Option Trader,greeks
Show Penny Options=order attribute,order column,option pricing,show penny options,num. options,penny option contracts
Show Portfolio Analytics=Interactive,positions
Show Positions=portfolio page,account window
Show price histogram=booktrader,book trader,column
Show real-time charts=Real-time,technical analysis
Show Rebalance Window=Order Entry Tools,portfolio,rebal %,redistribute,positions
Show SpreadTrader=Spread Trader,Combination,Calendar,Option,EFP
Show Total Row=calculate total,sum,global configuration,display
Show Trader Dashboard=Account data,Ticker,Real-time activity monitoring
Show volatility=chart parameters window,new chart window
Show volume=chart parameters window,new chart window
Show zero position rows=account window,portfolio
Show/Hide ChartTrader=chart
Show/Hide Index Panel=basket,basket trader,weight,market cap,beta,weighted components,true composition
Show/Hide Time Parameters Panel=chart
Show/Hide Volume=chart
Simple Moving Average=study,Avg.,technical indicator,overlayed
Simple Moving Avg.=study,Average,technical indicator,overlayed
Single Contract=import contracts
Smart Routing=Excluded Exchanges,Excluded quotes,non-firm quotes,non-electronic quotes,smartrouting
Socket Port=API,global configuration
Some options are hidden=features selector,features window
Sort=tickers,ascending,descending,reset,sorting
Sort by Current Page Order=ascending,descending
Sort by Security Type=ascending,descending
Sort Tickers=ascending,descending,reset,sorting
Sound Manager=Configure,events,beep,sound event type,audio,custom
Spread Columns=Spread,Trader,Combination,Calendar,Option
SpreadTrader=Spread,Trader,Combination,Calendar,Option,EFP
Start Time=VWAP,soonest,volume weighted average price
Statements=account management,flex,activity,report management
Statistics=option statistics,opt. volume change,option volume,optiontrader,option trader
Statistics Columns=option statistics,opt. volume change,option volume,optiontrader,option trader
Status=status colors,simulated order,accepted,cancelled,confirmed,confirmation,working,cancellation request
Stochastic Osc.=study,Technical indicator,non-overlayed,momentum,oscillator,overbought,oversold
Stochastic Oscillator=study,Technical indicator,non-overlayed,momentum,osc.,overbought,oversold
Stock Ref. Price=stock reference price,pegged to stock,pegged-to-stock,order type,speed of execution
Stocks=security type,shares,symbol,underlying
Stocks/Options=security type,shares,symbol,underlying,call,put,contracts
Stop Price=Protection,Order type,STP
Store settings on server=save settings,restore settings
Strike=option,strike price,call,put,strike date
Submit order=transmit
Submitter=Trades window,executions,submitter column
Subscribe to Market Data=Quotes,account management
Subsequent Component Size=scale order,profit offset,scale increment
Sweep to Fill=Sweep-to-fill,attribute,order type,routing,speed
Sweep-to-fill=Sweep to Fill,attribute,order type,routing,speed
Switch to Crosshair Mode=charts,toggle,cross-hair,price/value info,pop up,popup,price value information
Symbol=underlying,ticker,mode
Symbol Mode=underlying,ticker
The application will automatically log out=log off,logout,log-out
The following new features have been added=feature selector,feature window
Theta column=greeks,option,delta,risk,optiontrader,option trader,hedge,hedging
Ticker=symbol,underlying,security,row
TIF=time,force,duration,day,good,till,cancelled
Tile Charts (Grid)=sub-chart,subchart,add new chart
Tile Charts (Horizontal)=sub-chart,subchart,add new chart
Tile Charts (Vertical)=sub-chart,subchart,add new chart
Time & Sales=T&S,T & S,TandS,T and S,Technical Analysis,quotes,bars
Time in Force=order management line,parameter,time-in-force,TIF,duration,day,good,till,attribute,cancelled,immediate,until,timing,opening, date,GTC,OPG,IOC,GTD,DTC
Time period=interval,shift time period,prior day,prior week,prior month
Tip of the Day=hint,help
Toolbar=icons,buttons,tool bar,configure
Tools=market data tools,risk management tools
Total=sum
Total Shares:=quan,quantity,fills
TotalView Quotes=nasdaq,depth,total view
Trade=buy,sell,transmit,trades window,executions,order entry tools
Trade Columns=order,order columns,layout
Trade History=Trades window,executions
Trade Price=last price
Trader Dashboard=trader's dashboard,traders' dashboard,Account data,Ticker,Real-time activity monitoring,trading window
Traders' Chat=help,chat room
Trades=trades window,order book,executions,summary,export reports,profit,loss,P&L,P & L
Trading by dollar amount or percentage=quantity type,quantity value
Trading Window=watch list,market view,order book,monitor,main trading window,rapid order entry,pages,trader dashboard,layout,market data columns,hotkey,order management line,order columns
Trailing amount=user-defined,stop trigger price,trigger amnt.,attribute
Trailing Key=order columns,order management column,bracket,trailing stop,trailing amount
Trailing Stop=attribute,amount,trailing stop order,order type,trailing key
Transfer (DVP/RVP)=account management,transfer a position,account window,transfer in,transfer out,delivery vs. payment,receive vs. payment
Transmit=submit,instantaneously,send,buy,sell,execute
Transmit All=submit all,send all,execute all
Treasuries=bonds,bills,notes,bill,bond,note
Transmit instantaneously=submit,customize,hotkey,hot key
Transmit Order=submit order,send order,execute order
Transmit Page=submit page,send page,execute page
Trendlines=chart,technical analysis,draw,drawing,support,resistance
Trigger Method=order defaults,order ticket,last,double last,bid/ask,mid-point,double bid/ask,last or bid/ask
Trigger Price=adjustable stop,order columns,readjust
Trusted IP Addresses=permit,secure,allow
Try Portfolio Margin=Try PM,what if portfolio margin,what-if portfolio margin
Type=Order Wizard,order type,security type,volatility type
Ultimate Osc.=study,overbought,oversold,technical indicator,oscillator
Ultimate Oscillator=study,overbought,oversold,technical indicator,osc.
Underlying=ticker,ticker symbol,market data column
Underlying Mode=symbol mode,underlying,undrl.
Underlying Range (High)=undrl.,stock price monitoring,vol order type,volatility trading,above
Underlying Range (Low)=undrl.,stock price monitoring,vol order type,volatility trading,below
Undrl. Range (High)=underlying,stock price monitoring,vol order type,volatility trading,above
Undrl. Range (Low)=underlying,stock price monitoring,vol order type,volatility trading,below
Unrealized P&L=unrealized profit and loss,unrealized PnL,unrealized P & L,market data column,unrealized p and L
Unrealized P&L column=unrealized profit and loss,unrealized PnL,unrealized P & L,market data column,unrealized p and L
Unset Liquidate Last=margin requirements,liquidation queue
Unused Features=feature selector,feature window,enable feature
Update=Update Limit Prices
Update Limit Prices=update parameters,lmt price,refresh
Use condensed combo description=display settings,global configuration
Use per-contract quantity percentage=basket trader,baskettrader,execute basket
Value At Risk=VAR,Portfolio Analytics,Interactive analytics,worst case,perfect correlation
Vega column=greeks,option,risk,option trader,optiontrader,hedge,hedging
View=view audit trail,view account,view alerts,view trades,view system status
View Account=portfolio,account window
View Alerts=alert window
View Audit Trail=audit report,view audit trail,condensed,expanded
View System Status=system availability,outage
View Trades=trades window,executions window
Vol. Change=market data column,option volatility change
Volatility=volatility trading,volatility type,vol order type,continuous update,legs,hedging,hedge,delta neutral,option analytics
Volatility and Analytics=Interactive analytics,option analytics
Volatility Trading=vol order type,hedging,hedge,delta neutral,option analytics
Volatility Type=daily volatility,annual volatility,yearly volatility,vol order type
Volatility Units=model price,option model,implied volatility,option analytics
Volume=trading volume,market data columns,average volume,av. Volume
VWAP=Algo,Algorithm,Volume Weighted Average Price,ratio
Vwap Time=Algo,Algorithm,Volume Weighted Average Price,ratio
Warn on Exit with Position=message,positions
Web Site Links=help
WebTicket=help ticket,mistrade report,mis trade report,active ticket
Weighted Moving average=study,WMA,technical indicator,overlayed
Weighted Moving Avg.=study,WMA,technical indicator,overlayed
What to show=chart,parameters,midpoint,trades,volatility,bid/ask
What-if/Check-Margin feature=order preview,check margin,what if
Williams Osc.=study,momentum,Technical Indicator,Stochastic,oscillator,non-overlayed
Williams Oscillator=study,momentum,Technical Indicator,Stochastic,osc.,non-overlayed
Workspace Manager=container,desktop,workbench,layout,default workspace,import workspace,export workspace,new workspace,delete workspace,rename workspace,duplicate workspace
Yearly Volatility=vol. order type,volatility trading, annual volatility,volatility type
Zoom in=chart,magnifying glass
Zoom out=chart,magnifying glass
